sfa1	CCTTACTCCCAATTTCTACCT
sfaint	ACCATTTCCAAATTCCCACTC
sfajbot	TGAGTAGGTTGAATAGGAGTGCTCATCTATAACCTCACCCTCAGGTAGAAATTGGGAGTAAGG
sfarel1	CACTCCTATTCAACCTACTCA
sfajtop	GAGTGGGAATTTGGAAATGGTGAGGGTGAGGTTATAGATGAGAATTT
sfafmid	ACCTAATACCTCCAC
sfaout	CTCCATCCAACTACTAACTCT
sfafbot	AGAGTTAGTAGTTGGATGGAGCTCACCTAATACCTCCACCTCGAGTGGGAATTTGGAAATGGT
sfarel2	CACCTCTACACTACCCATTTA
sfaftop	TAAATGGGTAGTGTAGAGGTGGAGGTGGAGGTATTAGGTGAGAATTT
sfarel1bot	AGGTAGAAATTGGGAGTAAGGTGAGTAGGTTGAATAGGAGTG
sfarel2bot	GGTGAGGTTATAGATTGAAGGTAAATGGGTAGTGTAGAGGTG
sfa2	CCTTCAATCTATAACCTCACC
sfb1	CATATCACCATCTCACACTCT
sfbint	TATCTACCCTATTTCACCCTC
sfbjbot	GGATGTATAGGTAGGGATTGTCTCATACCATCCATTCCACTCAGAGTGTGAGATGGTGATATG
sfbrel1	ACAATCCCTACCTATACATCC
sfbjtop	GAGGGTGAAATAGGGTAGATAGAGTGGAATGGATGGTATGAGAATTT
sfbfmid	ACTCCATCAATCCAC
sfbout	CCTCAAACTCAACATTCATCC
sfbfbot	GGATGAATGTTGAGTTTGAGGCTCACTCCATCAATCCACCTCGAGGGTGAAATAGGGTAGATA
sfbrel2	AACTCACTTACCCTTATCTCC
sfbftop	GGAGATAAGGGTAAGTGAGTTGAGGTGGATTGATGGAGTGAGAATTT
sfbrel1bot	AGAGTGTGAGATGGTGATATGGGATGTATAGGTAGGGATTGT
sfbrel2bot	TGGAATGGATGGTATGGAAGTGGAGATAAGGGTAAGTGAGTT
sfb2	ACTTCCATACCATCCATTCCA